...............
.....▓.........
....▓▓▓........
..▓▓▓▓▓........
.▓▓▓▓..........
.▓▓▓..####-####
..▓▓..#.......#
......#.......#
......#.......#
......#########